장인 = artisan, craftsman

Self Study Korean - Shanna
맞춤법 = spelling
뛰어쓰기 = spacing
순우리말 = native Korean words

검색 = search
숙어 = idiomatic expression
예문 = examples
상세검색 = advanced search

Hangeul Master
모음 = collection
받침 = support (cup of tea)
라디오 = X-ray

Duolingo
이 = tooth
아이 = child (what about 애기(baby))
우유 = milk
우의 = friendship, raincoat
위 = stomach, top

Misc
시장 = mayor + hungry

shop
상점
shopping
쇼핑센터
쇼핑몰
백화점 department store

핵 = nuclear + hack

끝 = end

http://www.learnkoreanlanguage.com/Korean-Culture.html

등불(lantern, lamp(light)) - 크리스마스 조명 - 우산 안경 sunglasses 지갑 shop

라이브 = live
콘서트 = concert
뮤비 = music video (뮤직 비디오 ???)

와이파이 = wifi

새 = new, bird
앨범 = album (how about 집, 모음 ???)

님 > 씨
선생님
의사선생님 when addressing to him, not just 의사
교수님

생존 alive
